%%%%%%%%%%%%%%%%%%%%%%
%   $    %     %     %
%  $ $               %
%   $                %
%      $$$$$  $$$$$  %
%  %$$$$$%$  B %$$$$$%
%  $$$   $$$$%$$$    %
%$$%   E$%     %$$   %
%  $$$$   %$$$$$     %
%%%%%%%%%%%%%%%%%%%%%%
