%%%%%%%%%%%%%%%%%%%%%%%%%%%%%%%%%%
%    %     $$$$       E$$$$$$$   %
%  B     %     $$$$$$     %%%    %
%  E %$$$ $$$$%     %         %%$%
%$  $$$$$     %   $$$$$   B      %
%    %$$$$$   $$$$$   $  %    $ $%
%   $$$$%$$$       % E E E $     %
% E$%     %$$  %%%         %%$$$$%
%$   %$$$$$   B    $$$$$         %
% $$$$$  $$$$$     %   $$$$$   B %
%$$$%$    %$$$$$   $$$$$   $  %  %
%   $$$$%$$$       % E E E $     %
% E$%     %$$  %%%         %%$$$$%
%$   %$$$$$   B    $$$$$         %
%%%%%%%%%%%%%%%%%%%%%%%%%%%%%%%%%%