%%%%%%%%%%%%%%%%%%%%%%
%  %     %     %  %  %
%   E  $$$$%%%%      %
%  %$$$$$%   E %$$$  %
%      $$$$$  $$$$$  %
%  %$$$$$%$    %$$$$$%
%  $$$   $$$$%$$$    %
%$$%   E$%     %$$   %
%  $$$$   %$$$$$     %
%%%%%%%%%%%%%%%%%%%%%%
