%%%%%%%%%%%%%%%%%%%%%%
%   $    %     %     %
%  $ $               %
%   $                %
%      $$$%%%%%%%$$  %
%  %$$$$$%$ EEBE%$$$$%
%  $$$   %%%%%%%%    %
%$$%   E$%     %$$   %
%  $$$$   %$$$$$     %
%%%%%%%%%%%%%%%%%%%%%%
