%%%%%%%%%%%%%%%%%%%%%%
%  %     %     %     %
%      $$$$%%%%      %
%  %$$$$$%     %$$$  %
%      $$$$$  $$$$$  %
%  %$$$$$%$    %$$$$$%
%  $$$   $$$$%$$$    %
%$$%   $$%     %$$   %
%  $$$$   %$$$$$     %
%%%%%%%%%%%%%%%%%%%%%%
