%%%%%%%%%%%%%%%%%%%%%%
%  %     %     %     %
%   E  $$$$%%%%      %
%  %$$$$$%   E %$$$  %
%      $$$$$  $$$$$  %
%  %$$$$$%$  B %$$$$$%
%  $$$   $$$$%$$$    %
%$$%   E$%     %$$   %
%  $$$$   %$$$$$     %
%%%%%%%%%%%%%%%%%%%%%%
