%%%%%%%%%%%%%%%%%%%%%%
%   $    %     %     %
%  $B$               %
%   $   B            %
%      $$$$$  $$$$$  %
%  %$$$$$%$  B %$$$$$%
%  $$$   $$$$%$$$    %
%$$%   E$%     %$$   %
%  $$$$   %$$$$$     %
%%%%%%%%%%%%%%%%%%%%%%
