%%%%%%%%%%%%%%%%%%%%%%
%                    %
%                    %
%                    %
%         B          %
%                    %
%                    %
%                    %
%                    %
%%%%%%%%%%%%%%%%%%%%%%
